XXXXXXXXXXXXXXXXXXXXX
P     X X           X
X XXX X X X XXX XXX X
X X   X X X   X   X X
X X XXX X XXX XXX XXX
X X   X   X     X   X
X XXX XXXXX XXX XXX X
X   X       X   X X X
X X XXXXX XXXXX X X X
X X X     X   X X X X
X X XXXXXXX X X X X X
X X       X X X   X K
XXXXXXXXXXXXXXXXXXXXX