XXXXXXXXXX
P   X    X 
XXX   XXXX
XXX X X  X
X   X X XX
XXX X   XX
XXX XXXXXX
X   X X XX
XXX      K
XXXXXXXXXX
