XXXXXXXXXXXXXXXXXXXXXXXXXXXXXXXXXXXXXXXXXXXXXXXXXXXXXXXXXXXXXXXXXXXXXXXXXXXXXXXXXXXXXXXXXXXXXXXXXXXXXXXXXXXXXXXXXXXXXXXXXXXXXXXXXXXXXXXXXXXXXXXXXXXXXXXXXXXXXXXXXXXXXXXXXXXXXXXXXXXXXXXXXXXXXXXXXXXXXXXXXXXXXXXXXXXXXXXXXXXXXXXXXXXXXXXXXXXXXXXXXXXXXXXXXXXXXXXXXXXXXXXXXXXXXXXXXXXXXXXXXXXXXXXXXXXXXXXXXXXXX
P       X           X           X X               X       X         X X             X     X     X         X       X       X X               X         X           X                 X             X         X         X         X   X           X         X     X   X           X     X   X                 X
XXXXX X XXXXXXXXX XXX XXXXX XXX X X XXXXX X XXXXXXX X XXX X XXX XXX X X XXXXXXX XXXXX X X XXX XXX XXXXXXX X X XXX X XXXXX X X XXXXXXXXXXX X XXX XXXXXXX XXXXXXX XXX X XXXXXXXXXXXXXXX XXXXX XXXXX XXXXX XXX XXX XXXXX X XXXXXXX X X XXX XXXXXXX XXX XXXXX XXX X XXX X XXXXXXXXX X X X X X X XXXXXXXXXXX XXX X
X     X X         X   X   X X X X X     X X X   X   X X   X   X X X   X       X   X   X X     X   X     X   X   X   X     X   X   X     X X   X     X         X   X X     X     X   X   X   X   X   X   X X   X     X X     X X X X   X   X     X   X   X X   X   X     X     X   X X X X     X     X   X   X
X XXXXX X XXXXX XXX XXX XXX X X X XXXXX X X X X X XXX XXXXXXX X X X XXX XXXXXXX X X XXX XXXXX X XXXXXXX XXXXXXX X XXXXX XXXXX X X XXX XXX XXX XXXXX X XXXXXXXXX X X XXXXX X XXX X X XXX X XXX X XXX X XXX XXX XXX X X X XXX X X X XXX X X XXX XXX XXX X X X XXXXX X XXXXX XXX XXXXX X XXXXXXXXX XXX X XXXXX X
X X   X   X   X X   X     X X         X X X X X X   X X     X X X X X   X     X X     X   X   X   X   X       X X X   X     X   X     X   X X   X   X X   X   X X X     X   X   X X X   X     X X   X X     X   X X X X   X X     X   X X   X     X   X X   X     X X   X X         X           X   X     X X
X X X XXXXX X X X XXXXXXX X XXXXXXXXXXX X XXX X XXX X X XXX X X X X X XXX XXX XXXXXXX XXX XXXXXXX X X XXX X XXX XXX X XXXXX XXXXXXXXX X XXX XXX X XXX X X X X X X XXXXX XXXXX XXX X X XXXXXXXXX X XXX X X XXXXX X X X XXXXX XXXXXXX XXX XXX XXXXXXX XXX XXXXX XXXXXXX X X XXXXXXXXXXXXXXXXXXXXXXX XXXXXXX X X
X   X X     X X X     X   X             X     X X   X   X X   X X   X   X   X X   X     X   X   X   X     X X   X   X     X   X     X X X     X X X   X X X X X X   X   X   X     X   X   X     X     X X     X X X X     X X   X X X     X     X     X X X   X     X X X   X   X     X         X   X     X X
X XXX XXXXX X X XXXXX X XXXXXXXXXXXXXXXXXXXXXXX X XXXXXXX XXXXX XXXXXXX XXX X X X X XXXXXXX X X X XXXXX XXXXX X X XXXXXXX XXX X XXX X X XXXXX X X X XXX X X X XXX XXX XXXXX XXXXXXX XXX X X XXXXXXXXXXX XXX XXX XXX XXXXX X X X X X XXXXXXXXX X X XXX X X X XXXXX X X X XXX X X X X XXX X XXXXX XXX X XXXXX X
X   X X   X X       X X     X             X   X   X     X     X       X   X X   X X X     X X X   X   X X     X X X     X X     X   X X     X X X X X   X X X     X   X       X   X X   X X   X X     X   X   X   X X   X X   X X       X   X X X   X X   X       X X X X   X X X X     X   X   X X   X X   X
XXXXX X X XXXXXXXXX X X XXX X XXXXXXXXX X X XXXXXXX XXXXX X XXXXXXX XXXXX X XXXXX X X XXX X X XXXXX X X X XXXXX X XXX XXX X XXXXXXX X XXXXX X X X X X XXX X XXXXXXX XXX XXX XXX X XXX XXX XXX X X X XXXXX XXX XXX X X X X XXX X XXXXXXX X X XXX XXX X XXX XXXXXXXXX X X X XXX XXX XXXXXXX X X XXX XXXXX X XXX
X   X X X     X     X X   X   X         X X X   X         X     X X       X X   X X X X   X       X X X X X     X   X X   X X     X X   X   X   X   X X     X     X X     X X   X     X   X   X X X       X     X X X X X   X X   X X   X X     X X X   X X       X   X   X X       X   X X X   X       X   X
X X X X XXXXX XXXXXXX XXXXXXXXX XXXXXXXXX X X X X XXXXXXXXXXX X X XXXXXXXXX X X X X X X XXXXXXXXXXX X X X XXXXXXXXX X X XXXXX XXX X XXXXX XXXXX XXX X XXXXXXX XXX X XXXXX X X XXXXXXXXX XXX XXX X XXXXXXXXX XXXXX X X X XXX XXXXX X X XXX XXXXXXX X XXX XXX XXXXX XXXXXXXXX X XXXXXXX X X X XXX X XXXXX XXX X
X X   X X   X X   X   X         X   X     X   X   X       X   X   X     X   X X   X X X X         X X X X             X     X   X X     X     X   X X   X     X X X     X X X X   X         X   X   X     X     X   X X X X   X   X X X     X X   X   X X   X     X   X     X   X     X X X   X   X   X   X X
X XXXXX X X X X X X XXX XXXXXXXXX XXX XXXXXXXXXXXXX XXXXX X XXXXX XXXXX X XXX XXXXXXX X XXX XXXXX X X X XXXXXXXXXXXXXXXXXXX XXX X XXXXX XXXXX XXX XXXXX X XXXXX X XXXXX X X X X X XXXXXXXXXXX X XXX XXX X XXXXX XXXXX X X XXX X XXX X XXXXX X X X XXX X X XXX X XXX X X X XXXXX X XXXXX X XXX XXXXX XXXXX X X
X X       X X   X X     X         X   X       X   X     X X   X X X   X X   X   X     X X   X   X X X X   X   X           X   X X   X   X   X X X X   X         X     X   X X X X     X     X X         X X   X       X   X   X X X   X     X   X     X X   X X X   X X X     X X X   X X X X X   X   X   X X
X X XXXXXXX XXXXX XXXXXXX XXX X XXX XXX XXXXX X X XXXXX X XXX X X X X X XXXXXXX X X XXX X XXXXX X X X XXX X X X XXXXXXXXX XXX X XXX X XXX X X X X X X X XXXXXXXXXXX X XXXXX X X XXXXX X XXX XXXXXXXXXXXXX XXX XXXXXXX XXXXX XXX X X XXX XXXXXXXXXXXXXXX XXX X XXX XXX X XXX XXX X X XXX X X X X X X X X XXX X
X   X     X     X           X X X   X   X   X   X   X   X X   X X   X   X   X X X X   X X     X X   X   X   X X X     X X   X     X X   X X   X X X X X   X   X   X X X   X X X   X X     X       X     X   X   X     X   X     X X X     X               X X     X X     X     X X   X X   X X X   X   X   X
X XXX XXX X XXXXXXX XXXXXXXXX X X XXX XXX XXXXXXXXX X XXX X XXX XXXXXXX X X X X XXXXX X X XXX X XXXXXXX XXX XXX X XXX X XXX X XXXXX XXX X XXXXX X X X XXXXX X X X XXX X X X X XXX X XXXXXXXXXXX X XXX XXXXX XXX X XXXXX X XXXXXXX X X XXX X X XXXXX XXXXXXX XXXXXXX XXXXXXXXXXXXX XXX X XXXXX XXXXXXXXXXX XXX
X   X X   X X     X X     X   X X   X X   X       X X X X X X         X X X   X   X   X X   X X   X   X X   X   X   X     X X X   X X X X X     X   X X     X   X   X   X   X   X X     X     X X   X X         X X     X   X       X   X X X X     X       X         X X         X   X     X           X   X
X XXX X XXXXX XXX XXX XXX X XXX XXX X XXX X XXXXX X X X X X XXXXXXX X X X XXX XXX X XXX XXX X XXX X X X X XXX XXX X XXXXXXX XXX X X X X X X XXX XXXXX X XXXXXXXXXXX X XXXXXXX X X X XXX X XXX XXXXX X X XXXXXXXXX X XXXXX X X XXXXXXXXX X X X XXX XXX XXXXXXX XXX XXX X X XXXXXXXXX XXXXXXX XXXXXXX XXX XXX X
X X   X       X X   X X   X   X X   X   X X X   X   X X X X   X   X X   X X X X X   X   X   X X   X X   X   X X X X         X   X   X X   X X X     X   X   X   X   X X       X X X   X X   X   X   X X   X X     X   X   X X X     X   X X X   X X   X     X X   X     X   X   X         X X     X X   X   X
X X XXXXXXXXXXX XXX X X XXXXX XXX XXXXX X X XXX XXXXX X X XXX X X X XXXXX X X X XXXXX XXXXXXX X XXX XXXXXXXXX X X XXXXXXXXXXX XXXXXXX XXXXX X XXXXX XXXXX X X X X XXX X XXXXXXX X X X XXXXX XXX X XXX XXX X X XXXXXXX X XXX X X XXX XXX X X XXX X X XXX X XXX X XXXXXXX XXX X X X XXXXXXX X X XXX XXX X X XXX
X X     X   X     X X X X   X   X X     X X   X       X       X X X     X X X   X     X     X X     X         X X     X       X           X X     X   X   X   X   X X X X X     X X X X     X X   X         X X       X   X X   X X   X X X   X X X X   X     X X     X X X X X X X   X X X X   X     X X X X
X XXXXX X XXX X XXX X X X X X X X X XXXXX XXX X XXXXXXXXXXXXXXX X XXXXX X X X XXX XXXXX XXX X X XXXXX XXX XXXXX XXXXX X XXXXXXXXXXXXXXXXX X X X XXX XXX XXXXXXXXXXX X X X X XXXXX XXX X XXXXX XXXXX XXXXXXXXX X XXXXXXXXX X XXXXX XXX XXX XXX X XXX X XXXXXXXXX X XXX X X X X XXX X X X X X X X XXX XXXXX X X
X X     X X   X   X X X   X X X X X     X     X     X       X   X     X   X   X   X     X X   X X       X X     X     X X X         X     X   X X   X   X         X   X X   X         X X         X X   X X   X   X   X   X   X     X   X X   X X   X X   X   X   X   X   X X   X   X X X   X X   X X     X X
XXX XXXXX X XXXXX X X XXXXX XXX X XXX X XXX XXX XXX X XXXXX X XXXXXXX XXXXX XXX XXX X XXX XXXXX XXX XXXXX X XXX X XXXXX X X XXX XXX X XXX XXX XXX XXX XXXXXXX X XXX XXX XXXXX XXXXXXXXX X XXXXXXX X X X X X XXXXX X X X X XXXXX XXX XXX X XXXXX X XXX X X X X XXXXX XXXXX X X X XXXXX X XXXXX XXX X X XXXXX X
X   X       X     X X X   X     X   X X   X   X X X   X   X   X   X   X X   X X X   X X X     X   X X     X X   X X     X X   X X X   X   X   X   X   X       X X   X   X   X X   X   X X X   X   X   X   X     X X X   X X     X   X X X X     X X   X X   X X   X X     X X X     X   X       X X X       X
X XXX XXXXXXX XXXXX X X XXX XXXXXXX XXXXX XXX X X XXXXX XXXXXXX X X XXX X XXX X X XXX X X X XXXXX XXX XXXXX X XXX XXX XXX XXX X X X XXXXX X XXX X X XXX X XXXXXXX XXX XXX X X X X X X X X X X X XXXXXXXXX XXX XXX X XXXXX X XXXXX X X X X X XXXXX X XXX XXXXX X X X X XXXXX X XXXXX XXX X XXXXXXX XXXXXXXXX X
X   X   X   X         X     X       X     X X X       X X     X X   X   X     X X X   X   X X   X   X X     X   X   X   X   X X X   X   X X   X X X X   X   X     X X X   X X X X X X   X   X X X       X X X   X X X   X X X X   X X X   X X   X X     X     X X   X X X   X     X     X X   X   X       X X
X X XXX X X XXXXXXXXXXXXXXXXX XXXXXXX XXXXX X X XXXXX X X XXX X XXXXX XXXXX XXX X X XXX XXX X X XXX X X XXXXXXXXXXX XXX X XXX X XXXXX X XXXXX X X X X XXXXX X XXXXX X X XXX X X XXX XXXXX XXX XXX X XXXXX X XXX X X X XXX X X X XXX X XXXXX X X X XXXXXXX XXXXX XXXXX X X XXXXXXXXXXXXX X X X X X X XXX X X X
X X   X X X         X         X   X   X       X X   X   X   X X X   X       X   X X X X X X X X     X X           X   X X     X     X X     X X X X X   X X         X   X X     X   X       X X   X   X   X   X X X X     X X X   X         X X   X       X   X   X X X X       X     X X   X X X X X X X X X
X XXX X X XXXXXXXXX X XXXXXXXXXXX X X XXXXXXX XXX X XXXXXXX X X X X X XXXXXXX XXXXX X X X X X XXXXXXX X XXXXXXX X XXX X X XXXXXXXXX X XXX X X X XXX XXX X XXXXXXXXX XXXXX XXXXXXX XXX XXXXXXX X XXXXX X XXXXX X X X XXX XXX X XXX XXXXXXXXX X XXXXX XXXXXXXXX XXX X X X XXXXXXX X XXX X XXXXXXX X X X X XXX X
X   X X X       X   X X           X X       X     X   X     X   X X X   X X   X     X     X X   X     X X     X X   X   X   X     X X X X X X X   X X       X     X       X     X   X   X     X X   X X X     X   X   X   X     X     X     X X X             X   X X X       X X X X X     X   X X X X     X
X XXX X X XXXXXXX X X XXXXX XXX X X XXXXXXX XXXXXXXXX X XXXXXXXXX X XXX X X XXX X XXXXXXXXX XXX X XXXXX X XXX X XXX XXXXXXX X XXX X X X X X X XXX X XXXXXXX X XXX XXXXX XXX XXX XXX XXX X XXXXX X XXX X X X X XXXXXXX X XXXXXXX XXXXX XXX XXX X X XXXXXXX XXXXX XXX X X XXX XXX X X X XXXXX X X XXX X XXXXXXX
X X   X X X   X   X X     X X   X X       X X   X   X X X       X X   X   X   X X X       X X   X   X X X X   X X X   X     X X X   X X X X X X X X     X   X X     X   X   X   X   X   X         X   X X X X   X   X X X     X     X   X X   X X X X   X X     X     X X   X   X X X   X     X X   X       X
XXX XXX XXX X X XXXXXXXXX XXX XXXXXXXXX XXX X X X X X X X XXXXX X XXX XXX XXX XXX X X XXX X X XXXXX X X XXX XXX X X XXX XXXXX X XXX X X X XXX X X XXXXX XXXXX XXXXX XXXXX XXX XXX XXX XXXXXXXXXXXXX XXX X X XXXXX X X X X XXX XXXXX XXX X X XXX X X X X X X XXXXX XXXXX X XXX X X X XXX XXXXXXX X XXXXX XXX X
X   X   X   X   X     X X   X           X   X X   X X   X X   X X X X   X X X     X X   X X X X     X X   X   X X X X   X     X   X X X X     X X   X   X   X   X   X     X X     X   X     X X     X   X X   X   X   X X X X X     X   X X   X     X X X X X   X X     X X   X X X   X     X X X   X   X   X
X XXX XXX XXX XXX X X X XXX XXX XXXXXXXXX XXX XXXXX XXXXXXX X X X X X XXX X XXXXXXXXXXX X X X X XXXXX XXX XXX X X X X XXX XXXXX XXX X X XXXXXXX XXX X XXX X XXX X XXX XXXXX XXXXXXX XXX XXX X X XXX X XXXXXXX X XXXXX XXX X X X XXXXX X XXXXX XXXXXXX X XXX X XXX XXX XXXXX XXXXX X X XXXXX X X XXX X XXX XXX
X   X X   X X X   X X     X   X   X       X X X   X         X   X   X X   X     X     X X X X X X         X   X X   X X X     X     X   X         X   X   X   X X X   X X         X     X   X X X   X         X X   X X   X X   X X   X X     X   X   X X   X         X   X   X   X X X   X X     X   X X   X
X X X XXX X X X XXX XXXXXXXXX X XXX XXXXXXX X X XXXXXXXXX XXXXXXXXX X X XXX XXX X XXX X X X X X XXXXX XXXXX XXX XXXXX X XXXXX XXXXXXXXX XXX X X XXXXXXX X XXX X X XXX X X XXX XXX XXXXXXX XXX X XXXXXXXXX XXXXX X XXX X XXX XXXXX X XXXXX XXXXX X X XXX X XXXXXXXXXXXXX X XXX X XXX X X X X XXXXXXXXXXX XXX X
X X X   X X   X   X X       X X X   X       X X         X       X   X   X     X   X X   X   X X     X   X     X X     X     X     X   X   X X X X       X X   X X X   X X   X X   X X     X   X X         X     X   X X     X     X     X X     X   X X X X     X   X   X     X   X X   X X   X     X     X X
X X XXX X X XXXXX X X XXXXX X XXX XXX XXX X X XXXXXXXXX XXXXXXX X XXXXXXXXXXX XXXXX X XXXXX X X XXX XXX XXXXX X X XXXXX XXXXXXXXX X X XXX X X XXX XXXXXXX X XXX X X XXX XXX X X XXX X XXXXXXX X X XXXXXXXXX XXXXXXX X XXXXX X XXX XXXXX X X XXXXXXXXX X X X XXX X X X X XXXXXXXXX XXXXXXX XXX X XXX X XXX X X
X X X     X X X   X   X     X   X   X   X X X         X     X X X           X     X   X   X X X X   X   X   X X   X             X X X   X X X           X X     X X X   X   X X     X   X     X X X X       X     X X X X   X   X     X   X   X       X X X X X   X X X X       X   X     X   X X X X   X   X
X X XXXXXXX X X XXXXXXX XXXXXXX XXX XXXXX XXXXXXXXXXX XXX X X X XXXXXXXXXXX X XXX XXX X X XXX XXX XXX XXX X X XXXXX XXXXXXX XXX X X X X X XXXXX XXXXXXXXX XXXXXXX X X X X XXX XXXXX XXX XXX XXX X X X XXXXX X XXX X X X X XXXXX XXXXX XXXXXXX X XXXXX X X X X XXXXX X X X XXX XXXXX X XXX X XXX X X XXX XXXXX
X X     X     X       X       X     X     X     X   X X   X X X           X X   X   X X X     X   X   X   X       X X     X X   X   X X X X   X   X   X   X     X   X X X X X     X   X     X   X   X X   X X X   X     X X     X     X       X X     X X X X         X X X X     X X X X X     X X X   X   X
X XXXXX XXXXXXXXXXXXX XXXXXXX XXXXXXX XXXXX X XXX X X X XXX X X XXXXXXXXXXX XXXXXXX X X XXXXXXX XXX XXX XXXXXXXXX XXX XXX XXX X XXXXX XXX X X XXXXX X X XXX X XXXXXXX X X X XXXXX XXXXXXXXX X XXXXX X X X XXX X XXXXXXXXX XXXXXXX XXX X XXXXXXX X XXXXX X X XXXXXXXXXXXXX X XXXXX X X X X XXXXXXX X X XXXXX X
X     X                     X               X     X     X     X                     X X         X       X             X       X     X       X       X   X   X         X         X           X       X   X     X                   X     X       X         X                     X     X           X         K
XXXXXXXXXXXXXXXXXXXXXXXXXXXXXXXXXXXXXXXXXXXXXXXXXXXXXXXXXXXXXXXXXXXXXXXXXXXXXXXXXXXXXXXXXXXXXXXXXXXXXXXXXXXXXXXXXXXXXXXXXXXXXXXXXXXXXXXXXXXXXXXXXXXXXXXXXXXXXXXXXXXXXXXXXXXXXXXXXXXXXXXXXXXXXXXXXXXXXXXXXXXXXXXXXXXXXXXXXXXXXXXXXXXXXXXXXXXXXXXXXXXXXXXXXXXXXXXXXXXXXXXXXXXXXXXXXXXXXXXXXXXXXXXXXXXXXXXXXXXXX
