XXXXXXXXXXXXXXXXXXXXXXXXXXXXXXXXXXXXXXXXXXXXXXXXXXXXXXXXXXXXXXXXXXXXXXXXXXXXXXXXXXXXXXXXXXXXXXXXXXXXXXXXXXXXXXXXXXXXXXXXXXXXXXXXXXXXXXXXXXXXXXXXXXXXXXXXXXXXXXXXXXXXXXXXXXXXXXXXXXXXXXXXXXXXXXXXXXXXXXXXXXXXXXXXXXXXXXXXXXXXXXXXXXXXXXXXXXXXXXXXXXXXXXXXXXXXXXXXXXXXXXXXXXXXXXXXXXXXXXXXXXXXXXXXXXXXXXXXXXXXX
P           X             X         X X       X   X   X             X     X   X   X                         X       X   X     X   X       X       X                 X         X           X     X         X       X X                     X                 X       X       X   X                     X     X
X XXX XXXXX X XXXXXXX XXX X XXXXXXX X X XXX X X X X X X XXXXXXXXXXX X XXX X X X X X XXXXXXXXXXXXXXXXX XXX XXX XXX X X XXX X X XXX X X XXXXX XXXXX X XXXXXXXXXXXXX X X XXXXX X X XXX XXXXXXX XXX X XXXXXXX X X XXX X X XXXXXXXXX XXX XXXXX X XXXXXXXXX XXXXX XXX XXXXX XXX X XXX X XXXXXXXXXXXXXXX XXX XXXXX X
X X   X X   X       X X X   X     X X     X X X X   X X X   X     X X   X X X   X X X   X           X X   X     X X X     X X X   X X X     X   X   X   X     X   X X     X X X   X         X   X X     X X X X   X   X X     X X   X     X         X X   X X   X     X   X X   X   X           X   X   X   X
XXX XXX X XXXXXXXXXXX X XXXXXXXXX X X XXXXX X X XXXXX X X X XXX X X XXX X X XXXXX X X XXX XXXXX XXX X XXX X XXXXX X X XXXXX X X X X X X XXXXXXX XXXXX XXX XXX X XXX XXX XXX X X XXXXXXXXXXX X XXX X XXX X X X X XXXXX X X XXX XXX XXX XXXXXXXXX XXXXX X X X X XXX XXXXX XXX X XXXXX XXXXXXXXX XXXXX XXX X X X
X   X   X X         X X           X X X     X   X   X X   X X   X X     X X   X   X X   X X     X   X   X X X X   X X X     X   X X X X X   X   X     X   X X X X   X   X   X X X     X   X X     X   X X X X X     X   X   X     X X   X   X   X   X X X   X     X     X   X                 X     X     X X
X XXX XXX XXX XXXXX X X XXXXXXXXXXX XXX XXXXXXXXX XXX X XXX X XXXXXXX XXXXXXX X XXX X X X X XXXXX XXXXX X X X X XXX XXX XXXXXXX XXX X X X X X X X XXXXX XXX X X XXXXX XXX XXXXX X XXX X X XXX XXXXXXX X X X X XXXXX XXXXXXX XXXXXXX XXX X X XXXXX X X X XXXXX XXXXX XXXXX XXXXXXXXXXXXXXXXXXX X XXXXXXXXXXXXX
X   X   X     X   X X X           X X   X       X     X X   X         X     X X X   X X   X X   X     X X X   X   X     X     X X   X X X X   X X X     X   X X       X X       X X X X X   X X     X X X X X   X X         X     X   X   X     X X   X X     X     X     X   X   X     X     X       X     X
XXX X X XXXXXXX X X X X XXXXXXXXX X X XXX XXXXX XXXXX XXX X XXXXXXXXXXX X XXX X X XXXXXXX X X X XXX XXX X XXX XXX XXXXXXX XXX XXX XXX X X XXXXX X X XXXXX XXX X XXXXX X XXXXXXXXX X X X XXX X X XXX X X X X XXX X XXX XXXXXXX XXX X X XXXXXXXXX X XXXXX XXXXXXX XXXXX XXXXX X X X X XXX X XXXXXXXXX X X XXX X
X   X X     X   X X   X         X X   X   X   X     X X   X X           X     X X       X X   X X X X   X   X   X     X   X X       X     X       X X       X X X   X X   X     X X X X X X X   X X   X X   X X X     X     X X X X X         X X     X X     X     X X     X X X X   X X X       X X   X   X
X XXX XXX X X XXXXXXXXXXXXXXX XXX XXX X XXX XXXXXXX X X X XXX XXXXXXXXXXXXXXXXX XXXXXXX XXX XXX X X X XXXXX XXX XXXXX X XXX XXXXXXXXXXXXXXXXXXXXXXX X XXXXX X XXX X X X X XXXXX X X X X X X XXXXX XXXXX XXXXX X XXXXXXX XXX X X X X XXXXXXXXXXX XXXXX X X XXX XXXXX X X X XXX X X X X X X X XXXXX XXXXXXX X X
X X X   X X X X             X X     X X   X     X   X   X X   X X       X     X       X   X   X X   X X       X X   X X X   X     X               X X X     X     X X X X       X X     X   X X     X   X     X       X   X     X X             X     X   X X   X   X X X   X   X X X X X X X   X     X   X X
X X X XXX X X X XXX XXXXXXX XXX XXXXX XXX XXXXX X XXXXXXXXX XXX X XXXXX X XXX X X XXX XXX XXX X X XXX X XXXXXXX X X X X XXX X XXX X XXXXXXXXXXXXX X XXX XXX XXXXXXX X X XXXXXXX X XXXXXXX XXX X XXX X XXX XXXXXXXXXXX XXX XXXXXXX X XXXXX XXXXXXX XXXXXXXXX XXX X XXX X XXX XXXXX XXX XXX X X X XXXXX X XXX X
X X   X   X   X X X   X       X     X   X       X           X   X     X X   X X X X   X   X   X X   X X X   X     X X X   X   X   X X     X   X   X     X       X   X X X       X       X   X     X X X             X   X X       X X   X   X     X       X   X X X X X X   X     X   X   X   X   X X X   X X
X XXXXX XXXXX X X XXX XXXXXXX XXXXX XXX XXXXXXX XXXXXXXXXXXXX X X XXXXX XXX X X X X XXX XXX XXX XXX X XXX X X XXXXXXX XXX XXX X X X X XXX XXX X XXX XXXXXXXXXXXXX XXX X XXXXX XXXXXXXXX XXX XXXXXXX X XXXXXXXXXXXXX XXX X X XXXXXXX X X XXX XXX XXXXX XXX X X X X X X XXX XXX XXXXX XXX XXXXXXXXX X X XXX XXX
X     X     X X X   X     X           X       X X       X X   X   X   X   X X X X X X   X     X   X X     X X X         X   X X X X X X   X   X     X             X   X     X   X   X X X X       X   X               X   X X     X X X   X X   X     X   X X X   X X     X   X X     X   X       X X   X   X
X XXX XXXXX X X X XXXXXXX XXXXXXX XXXXXXXXXXX X X XXXXX X X XXXXXXX X XXX X X XXX XXX XXXXXXXXX X XXXXXXX X X X XXXXXXXXXXX X X XXX X XXX X X XXXXXXX XXXXXXXXXXXXX XXXXXXX XXX X X X X X XXXXXXX X XXX XXXXXXXXX XXXXXXXXX X XXXXX X XXX X X XXX X XXX XXX X XXXXX XXXXXXX XXX X XXX XXX X XXXXXXX XXX X X X
X   X X     X X X X     X X   X   X         X X   X     X X X   X   X     X X     X   X       X X X     X X X X   X     X   X X   X X   X   X   X   X X   X X     X   X   X   X   X X X X   X     X   X     X X   X     X   X   X   X X X X   X X X   X X   X           X   X     X     X X X     X     X X X
XXX X X XXXXXXX X X XXX X X X XXX X XXXXXXX X XXXXX XXXXX X XXX X XXXXXXX X XXXXXXX XXX XXXXX XXX X XXX XXX X XXX X XXX X XXX XXX X XXX XXXXXXX X XXX X X X X XXX XXX X X XXX XXXXX X X XXX X XXXXXXX XXX X X X XXX X XXX XXX X X XXX X X XXXXX X XXX X XXXXXXXXX XXXXXXX XXXXXXXXX XXXXX X X XXX X XXXXXXX X
X   X X           X   X X   X   X X   X   X X   X   X   X       X X       X         X   X   X X   X X X   X     X   X   X   X X   X     X   X   X X   X X X   X     X X X     X       X   X   X     X   X X X   X   X   X   X X     X X X     X   X   X X     X   X   X   X     X   X   X X   X X X X       X
XXXXX XXXXXXXXXXXXXXX X X XXXXX X XXX X X X X XXX XXX X X XXXXXXX X XXXXXXXXXXXXXXXXX XXX X X X X X X XXX XXXXXXX XXX XXXXX X X XXXXXXXXX X X XXX X XXX X X XXX XXXXX X XXXXX XXXXXXXXXXX X XXXXXXX XXX XXX XXXXX XXXXX XXX XXXXX XXX X XXXXX XXXXX XXX X XXX X XXX X X XXX XXX X XXX X X XXXXX X X XXXXX XXX
X     X       X   X   X X X   X X X   X X X   X   X   X X X     X X   X           X   X X X   X X X   X   X     X   X X   X X X         X X   X   X     X X   X       X X X   X       X   X X       X X   X       X     X   X   X X   X   X   X     X   X X X X     X X     X   X     X X X     X X     X   X
X XXX X XXXXX X X X XXX X X X X XXX XXX X XXXXX XXX XXX X X XXX X XXX X X XXXXXXX X XXX X XXXXX X XXX X X X XXX XXX X X X X XXX X XXXXXXX XXXXX X XXXXXXX XXX XXXXXXXXX X X XXX XXXXX X XXX X XXXXX X XXX X XXXXXXX XXX X XXX X X X XXXXX X XXX XXXXX XXX X X X XXXXX XXXXXXX XXX XXXXX X X XXXXX XXXXX XXX X
X   X X X   X X X X   X X X X X       X X   X   X   X   X X   X   X   X X   X     X   X X X     X X   X X X X X   X X   X     X X     X   X X   X       X   X           X     X X   X   X   X X   X   X   X     X   X X X   X X X X X     X X   X   X     X   X     X       X   X     X X X X     X   X     X
XXX X X X X X X X XXX X X X XXXXX XXXXX XXX X XXXXX X XXXXXXX XXXXX XXXXXXX XXX XXXXX X X X X XXX X XXX XXX X XXX XXXXXXXXXXX XXXXX X X XXX X XXX XXXXXXXXXXXXXXXXX XXXXXXXXXXX X X XXXXX XXX X X XXXXX XXX XXXXX XXX X XXX X X X X X X XXX X XXX X XXXXXXX XXXXXXX XXX XXXXXXX XXXXX X X X X XXXXXXX XXXXX X
X   X X   X X   X X   X X   X   X X     X X   X     X   X   X   X   X     X   X       X X X X X   X X X   X X   X   X     X X     X X X   X     X     X         X   X     X   X   X X X   X     X   X   X   X   X   X X   X   X X X   X X   X     X   X   X X   X   X   X       X X   X X   X X         X   X
X XXXXXXX XXXXXXX X XXX XXXXX X XXX XXXXX XXXXX XXXXXXX X X X X XXX X XXX XXX XXXXXXXXX X X X XXX X X XXX X X X XXX X XXX X XXXXX XXX XXX X XXXXXXXXX X XXXXX XXX XXX XXX X X XXXXX X X XXX XXXXXXX X XXXXXXX X X X X X XXXXX X X XXX XXX XXX XXXXXXX X X X X X XXXXX X X XXXXXXX X XXX X XXX XXXXX XXX X XXX
X         X     X X   X       X     X         X   X   X X X X X   X   X X X   X   X X   X X X   X X X   X X X X   X X   X X         X   X X X       X X X   X     X   X X X X     X X X X   X     X   X       X X X X   X   X X X   X X   X X X   X X   X X   X       X X     X   X   X   X   X     X   X   X
X XXXXXXXXX XXX X XXX XXXXXXXXXXXXXXX XXXXX XXX X X X X X X XXXXX XXXXX X X XXX X X X X X X XXX XXX X X X X XXXXX X X XXX XXXXXXXXX X XXX XXX XXXXX X X X X XXXXXXX XXX X X XXXXX X X X XXXXX XXX XXX XXX XXXXX XXX XXXXX X XXX XXXXX X XXX X X X X XXXXX XXX XXXXXXXXX XXXXX X X XXX XXXXX XXX XXXXX XXXXX X
X     X X   X X X   X X             X X   X     X   X X X X       X   X   X X   X   X X   X X X   X   X X X     X X   X   X     X     X   X   X     X   X X X       X   X   X   X X X   X     X X   X     X   X     X     X   X X     X X   X   X   X   X   X X     X   X     X X   X X X   X   X     X   X X
XXXXX X X XXX X XXX X XXX XXXXXXXXX XXX X XXXXXXX XXX X X XXXXXXXXXXX X XXX X XXXXXXX XXXXX X XXX XXXXX X XXXXX X XXXXX XXX XXX XXXXX X XXX XXXXX XXXXXXX X X XXXXXXX XXXXXXXXX X X X XXX XXXXX XXX XXXXXXX XXXXXXX X XXXXXXX X X XXXXX X X X XXXXXXX X XXX XXX XXX XXXXX XXXXX XXX X X X XXX X XXX XXX XXX X
X   X X X   X X X   X   X   X   X     X X       X X   X   X     X     X X   X     X   X         X   X   X     X X   X   X   X X   X   X   X X   X       X X X X X     X       X X   X X   X     X   X   X           X X   X   X X     X X X   X       X X   X     X   X   X   X X X   X X X   X   X     X   X
X XXX X XXX X X X X XXX X X X X XXXXX X XXXXXXX XXX XXXXXXX X X XXX XXX X X XXXXX X XXXXXXXXX XXXXX X XXXXXXX X X XXX X X XXX XXX XXXXXXX X X X XXXXXXX X X X X X XXX X XXX X X XXXXX X XXXXXXX X XXX X X XXXXXXXXX X XXX X XXX XXXXX X X XXXXX XXXXXXX X XXX XXXXXXX X XXX XXX X XXXXX X XXXXX X XXXXX X XXX
X     X   X X   X X X   X X   X     X   X     X   X X   X   X X   X X   X X X   X     X     X X     X X     X X   X   X X X     X         X   X X     X   X X X   X X   X   X     X   X X       X   X X X     X   X X   X   X     X   X X X   X   X X     X   X       X X     X X       X     X X   X X X   X
X XXXXX X X X XXX X X XXX XXXXXXXXX XXXXXXX X XXX X X X XXXXX XXX X X XXX X X X XXXXX X XXX X X XXXXX X XXX X XXX X XXX X X XXX XXXXXXXXXXXXXXX X X X XXXXX X X XXX XXXXX X XXXXX X XXX X X XXXXXXX X XXXXXXX X X X XXX X XXXXXXX X XXX XXX X XXX X X XXXXX XXX XXXXX X X XXX X X XXX XXXXXXX X XXX X X XXX X
X       X X X   X X X   X     X   X       X X       X X   X   X     X   X X X X     X   X   X X     X X X   X X   X X   X X   X           X     X X X     X   X       X   X X   X X     X X X     X X         X X X X   X         X X X     X   X X   X     X   X X   X X X   X   X   X       X X X X     X X
X XXXXXXXXX XXX X XXXXX XXXXXXX X XXXXXXX XXXXXXX XXX XXX X XXXXXXXXXXX XXX X XXXXX XXXXX XXXXXXX X X X XXXXX X XXX X XXX XXX XXXXXXX XXX X XXXXX X XXXXX XXXXX XXXXXXX X XXX X XXXXXXXXXXX X X XXX X XXXXXXX X X XXX XXXXXXXXXXXXX X XXXXXXXXX X XXXXX XXXXX XXX X XXX XXX XXXXXXX XXX XXXXXXX X X XXXXXXX X
X X   X     X X X X   X     X   X   X   X X     X X   X X X   X       X   X   X X   X   X X     X X X X     X   X X X   X   X       X X   X X   X X X   X X   X X       X X   X             X X X   X X     X X X   X             X     X   X   X X     X   X   X   X X X   X   X   X X     X     X X     X X
XXX X X XXXXX X X X X XXXXX X XXXXX X X X X XXX XXX XXX X X X X XXXXX XXX X XXX X XXXXX X XXX X XXX X X XXX XXXXX X XXXXXXX XXXXXXXXX X XXX X X XXX X X X XXX X X XXXXXXXXX XXXXXXXXXXXXX XXX X X XXX X XXX XXX XXX XXXXXXXXXXXXX X XXXXX X X XXX X XXXXX X XXX X XXX X X X X X X XXX XXXXX XXXXX X X XXX X X
X   X X X     X   X X     X   X   X X X X   X   X   X   X X X   X   X   X X   X X     X X   X X X   X X   X     X X X     X   X       X   X   X   X X X   X   X X X     X   X         X X     X X X   X X       X   X   X       X   X   X X X X   X     X X   X X X   X X X X X       X   X   X   X   X X   X
X XXX X X X XXX XXX X XXXXXXXXX X X X X XXXXX XXX XXX X X X XXXXX X X XXX XXX X XXXXX X XXX X X X X X X XXXXX X X X X X XXXXX X XXXXXXXXX X XXXXX X XXX XXX X X X X XXX X XXXXX X XXX X XXXXXXX X X XXX XXXXXXXXX XXX X X XXXXX X XXX X X X X XXX XXXXX X X XXX X X XXX X XXX XXXXXXXXX X XXX X XXXXXXX XXXXX
X   X   X X     X   X   X       X X   X     X     X   X X X X X   X   X   X X   X X   X   X X X X X X X X     X   X   X   X   X   X     X X   X   X   X   X X X X   X   X     X X X         X X X X X X     X         X   X   X X X   X   X X   X     X X X X   X   X   X     X         X   X X   X   X   X X
X X XXXXXXXXXXX X XXXXX X XXXXXXX XXXXXXXXX X XXXXX XXX X X X X XXX XXX XXX XXX X X XXX XXX X X X X X X X XXXXXXX XXXXXXX X XXX X X XXX X XXX X XXX X XXX X X X XXXXX X XXXXX X X XXX XXXXX X X X X X XXXXX XXXXXXXXXXXXXXX X X XXX XXXXXXX XXX X X XXX X X X XXXXX X XXXXXXXXX XXXXXXXXXXX X XXX X X X X X X
X X     X     X X X X   X X   X X       X   X       X   X X   X X   X   X   X   X X X X   X X X   X X X X X     X X     X   X   X X   X X   X X   X X   X   X X   X X X X     X X   X X   X   X   X   X   X   X       X     X X     X     X     X X     X X X X X   X         X X   X       X   X X X   X   X
X XXXXX X XXX X X X X XXX X X X XXXXX X X XXXXX XXXXXXX X XXX X XXXXX XXXXX X XXX X X X X X X XXXXXXX X X X XXX X XXXXX XXXXXXXXX X X XXXXX XXXXX X XXX XXXXXXXXX X X X X XXXXXXXXX XXX X XXX XXXXXXX XXX XXX X XXXXX XXXXX X XXXXXXX X XXXXXXXXX XXXXXXX XXX X X XXXXXXXXXXX X X X X XXXXXXX X X X XXXXXXX X
X X   X X X   X X   X     X X       X X X X   X X     X X   X X   X   X   X       X X   X X   X       X X X   X X X   X           X X   X   X   X X X X     X     X X X X X       X     X   X X     X       X     X   X     X X       X X       X X       X   X   X         X   X X X X       X X X X       X
X XXX X X X XXXXXXX XXXXXXX XXXXXXX X XXX X X XXX XXX XXXXX X XXX X XXX X XXXXXXXXX X XXX XXX X XXXXXXXXX X X XXX X X X XXXXXXXXXXX XXX X XXX X X X X XXXXX X XXXXX X XXX XXX XXX XXXXXXXXX X XXX X XXXXXXXXXXXXXXX XXX XXXXXXX XXXXXXX X XXX XXX XXXXX X X XXXXXXX XXXXX XXXXXXX X X XXXXXXXXX X X X XXXXXXX
X     X   X                 X       X       X     X         X   X       X           X   X     X           X X       X   X             X       X   X       X         X         X             X     X                 X                 X     X           X X             X         X             X   X       K
XXXXXXXXXXXXXXXXXXXXXXXXXXXXXXXXXXXXXXXXXXXXXXXXXXXXXXXXXXXXXXXXXXXXXXXXXXXXXXXXXXXXXXXXXXXXXXXXXXXXXXXXXXXXXXXXXXXXXXXXXXXXXXXXXXXXXXXXXXXXXXXXXXXXXXXXXXXXXXXXXXXXXXXXXXXXXXXXXXXXXXXXXXXXXXXXXXXXXXXXXXXXXXXXXXXXXXXXXXXXXXXXXXXXXXXXXXXXXXXXXXXXXXXXXXXXXXXXXXXXXXXXXXXXXXXXXXXXXXXXXXXXXXXXXXXXXXXXXXXXX
